%%%%%%%
%     %
% %%% %
% %.  %
%P%%% %
%G G  %
%%%%%%%
